300 250
00000000000000000000000000000000
00000000000000000000000000000000
00000000000000000000000000000000
00000000000000000000000000000000
00000000000000000000000000000000
00000000000000000000000000000000
00000000000000000000000000000000
00000000000000000000000000000000
00000000000000000000000000000000
00002200000000022200000000000000
00021122220002211122000000000000
00011111112221111111000000000000
00011111111111111111000000000000
00211111111111111330000000000000
00113333111333333330000000000000
00333333333333333300000000000000
00033333333333344000000000000000
00033333344334444000000000000000
00000033444004440000000000000000
00000000440004040000000000000000
00000000040000000000000000000000
00000000000000000000000000000000
00000000000000000000000000000000
00000000000000000000000000000000
00000000000000000000000000000000
00000000000000000000000000000000
00000000000000000000000000000000
00000000000000000000000000000000
00000000000000000000000000000000
00000000000000000000000000000000
00000000000000000000000000000000
00000000000000000000000000000000